//This file maps vert shader entry points to the input layout type
WPosVS	VPos
WNormWPosTexVS	VPosNorm
WNormWPosVColorVS	VPosNormCol0
TexTriVS	VPosNormTex0
WNormWTanBTanTexVS	VPosNormTanTex0
WNormWTanBTanWPosVS	VPosNormTanTex0
WNormWTanBTanWPosInstancedVS	VPosNormTanTex0
WNormWPosTexVS	VPosNormTex0
DMNVS	VPosNormBone
DMNDanglyVS	VPosNormBoneCol0
SkinWNormVS	VPosNormBone
SkinWNormWPosVS	VPosNormBone
SkinWNormWPosTex0VS	VPosNormBoneTex0
ShadowSkinWPosVS	VPosNormBone
SkinWNormWPosColorVS	VPosNormBoneCol0
SkinDanglyWnormWPos	VPosNormBoneCol0
SkinTexTriColVS	VPosNormBoneTex0
SkinTex0Tex1TriColVS	VPosNormBoneTex0Tex1
TextVS	VPos2Tex02
ShapeVS	VPos2Col0
KeyedGumpVS	VPos2Tex04
ParticleVS	VPos4Tex04Tex14
ParticleDMNVS	VPos4Tex04Tex14
LightMapVS	VPosNormTex04
VertexLitVS	VPosNormTex0Col0
FullBrightVS	VPosNormTex0
SkyVS	VPosTex0
LightMapAnimVS	VPosNormTex04Tex14Tex24Col04
SimpleQuadVS	VPos
SimpleQuad93VS	VPos
SimpleVS		VPos